................................................................................................
................................................................................................
................................................................................................
................................................................................................
................................................................................................
....................................................................###############.............
....................................................................#-------------#.............
....................................................................#--------#----#.............
....................................................................#-########----###...........
....................................................................#------#.#------#...........
....................................................................#------#.####---#######.....
....................................................................#------#....#---------#.....
......................................################..............#------#....###-------#.....
......................................#--------------#..............#------#......#-------###...
.........................##############------#-------###............######-#......#---------#...
.......................###------------#------#---------###############-----#......#######---###.
.......................#-----#--------#------#######---##------------#-----#............#-----#.
..................######---###---------------#.....#----#---#--------#-----#............###---#.
..................#--------#.#################.....###------#--------#-----#..............#---#.
..................#------###.######..................########--------#-#####..............#---#.
..................#------#...#----###...............################-#-----#.........########-#.
..................#------#...#------#...............#---------#------#-----#.........#--------#.
..................#------#...####---##############..#------#--#------#######.........#--------#.
..................#-######......#----#-----------#..#------#--#------#.............###--------#.
..................#----#........###--#---#-------#..#-######--#------#.............#----------#.
..................#----###........#--#---#######-#..#----#.#---------#...........###---########.
..................#------#........#--#---##------#..#----#.###########...........#-----#........
..................####---#######..#------##------#..#----###...................###---###........
.....................#---------############------#..#------#################...#-----#..........
.....................###-------#----------#------#..####---##--------------#####---###..........
.......................#-------#--#--------------#.....#----#------#-------#-------#............
.......................#----------################.....###--#------#-------------###............
.......................############......................#---------###############..............
.........................................................###########............................
................................................................................................
................................................................................................
